****************************
*............**............*
*.****.*****.**.*****.****.*
*.*  *.*   *.**.*   *.*  *.*
*.****.*****.**.*****.****.*
*..........................*
*.****.**.********.**.****.*
*.****.**.********.**.****.*
*......**....**....**......*
******.*****.**.*****.******
     *.*****.**.*****.*
     *.**..........**.*
     *.**.***  ***.**.*
******.**.*      *.**.******
..........*      *..........
******.**.********.**.******
     *.**..........**.*
     *.**.********.**.*
******.**.********.**.******
*............**............*
*.****.*****.**.*****.****.*
*.****.*****.**.*****.****.*
*...**................**...*
***.**.**.********.**.**.***
***.**.**.********.**.**.***
*......**....**....**......*
*.**********.**.**********.*
*.**********.**.**********.*
*..........................*
****************************
